
NO textures/Goiko.xpm
SO              textures/Iker.xpm
WE       textures/canita.xpm
EA    textures/fary.xpm


C  0,0, 255

F 28, 229, 7 

11111111111111111
1001   10000001
 10011100111101
  10010001  101
   1001011  101111111111111111
   1000N001 100000000000000001
111111111111111111111111111111