NO textures/Goiko.xpm
SO              textures/Iker.xpm
WE       textures/canita.xpm
EA    textures/fary.xpm
C   0,0, 255
F 28, 229, 7  
111111111
1000000N1
111111111 